     c      O
 B B M M B B
 B B MMM B B
CB B M M B B
 B B     B B
         A
M MM     MM M
     B B
 B B MBM B B
 B B B B B B
 B B     B B
 B B BBB B B
    PBFB